0 0 0 0 0 0 0 0 0 0 5 5 5 5 5 5 
0 0 0 0 0 0 0 0 0 0 1 3 3 3 3 5 
4 0 0 0 0 0 0 0 0 0 3 3 3 3 3 5 
4 4 0 0 0 0 0 0 0 0 5 3 3 3 3 5 
2 4 4 4 0 0 0 0 0 0 5 5 5 5 5 5 
2 2 2 4 4 4 0 0 0 0 0 0 0 0 0 0 
2 2 2 2 2 4 4 0 0 0 0 0 0 0 0 0 
2 2 2 2 2 2 4 4 4 0 0 0 0 0 0 0 
2 2 2 2 2 2 2 4 4 4 0 0 0 0 0 0 
2 2 2 2 2 2 2 2 2 4 4 0 0 0 0 0 
2 2 2 2 2 2 2 2 2 2 4 4 0 0 0 0 
2 2 2 2 2 2 2 2 2 2 2 4 4 0 0 0 
