0 0 0 0 0 0 0 0 0 6 5 5 5 5 5 5 
0 0 0 0 0 0 6 0 0 0 1 3 3 3 3 5 
4 0 0 0 6 0 7 0 7 7 3 3 3 3 3 5 
4 4 0 0 0 7 0 7 0 6 5 3 3 3 3 5 
2 4 4 4 7 0 0 6 0 0 5 5 5 5 5 5 
2 2 2 4 4 4 0 0 0 0 6 6 6 6 6 6 
2 2 2 2 2 4 4 0 0 0 0 6 6 6 6 6 
2 2 2 2 2 2 4 4 4 0 0 0 6 6 6 6 
2 2 2 2 2 2 2 4 4 4 0 0 6 6 6 6 
2 2 2 2 2 2 2 2 2 4 4 0 0 6 6 6 
2 2 2 2 2 2 2 2 2 2 4 4 0 0 6 6 
2 2 2 2 2 2 2 2 2 2 2 4 4 0 6 6 